# David Cao, Tung Doan - Picobot Maze - Lab 1

0 x*** -> N 1
0 N*** -> X 3
1 *x** -> E 2
1 *E** -> X 0
2 ***x -> S 3
2 ***S -> X 1
3 **x* -> W 0
3 **W* -> X 2


